#####################################################################################################
#...#     #      .....#           #      .......#      .....#     #  .............#...#             #
###.# # ### #####.###.### ####### # #####.#####.#######.###.# # ### #.###########.#.#.# ####### ### #
#...# #     #...#...#...#   #...#       #...#  ...#.....# #.# #     #...#...#.....#.#.# #     #   # #
#.### #######.#.###.###.# ###.#.######### #.#####.#.##### #.### #######.#.#.#.#####.#.# ### ##### ###
#.#   #   #...#.....# #.# #...#.........# #.....#...#...# #...#   #...#.#.#...#    .#.#   #     #   #
#.# ### ###.######### #.###.###########.# #####.#####.#.# ###.#####.#.#.#.#########.#.### # # ##### #
#.# #   #...#       # #.....#   #     #.#     #.....#.#.#   #.....#.#...#...#.....#.#...# # #     # #
#.# ### #.##### ### # ####### # ### # #.####### ###.#.#.# #######.#.#######.#.###.#.###.# ##### # # #
#.#     #.#     # #   #       #   # # #.......#   #...#.#       #.#.#     #.#...#...#...#     # # # #
#.#######.# ##### ### # ######### ### #######.##### ###.# # #####.#.# #####.###.#####.####### # # # #
#.........#...#     #   #     #   #     #   #.....# # #.# #     #...#     #...#.#   #.#       # # # #
###########.#.# ### ####### # # ### ### ### #####.# # #.# ##### ######### ###.#.# ###.### ##### # # #
# #.........#.#   #   #     # # #   #       #.....#   #.# #   #             #...#    ...#   #   # # #
# #.#########.# # ##### # ##### # ### ##### #.#########.# # # # ############### #######.### # ##### #
# #.#     #...# #       # #     # #   #...# #.#  .......#   # #                 #...# #...#   #     #
# #.# ### #.######### ### # ##### #####.#.# #.# #.################# #############.#.# ###.##### ### #
#...# #   #.#.......# #   # #     #.....#.# #.# #...........#.....# #...#.........#.#   #.....#   # #
#.### # # #.#.#####.# # ### ### # #.#####.###.##### #######.#.###.###.#.#.####### #.# # #####.### # #
#.#   # # #.#.....#.# #   # #   # #.    #.#...#...# #.......#...#.....#...#.....# #.# #     #.#   # #
#.##### # #.#####.#.### # # # ### #.#####.#.###.#.###.##### ###.###########.###.# #.####### #.# #####
#.....# # #.#.....#...# #   # #   #.#.....#.#  .#.....# #   #...#   #.....#...#.# #...#   # #.#     #
#####.# # #.#.#######.# ##### #####.#.#####.###.# ##### # ###.##### #.###.###.#.# ###.# # # #.##### #
# #...# # #...#     #.#       #...#.#.......#...# #...#   # #.......#.#  .....#.# #...# #   #.......#
# #.### ####### #####.#########.#.#.#########.#####.#.# ### #######.#.#########.###.### ### #######.#
# #.#               #...........#...#.......#.#.....#.#   #   #.....#...#.......#...#     #   #   #.#
# #.####### ####### #################.#####.#.#.#####.### ### #.#######.#.#######.####### # ### # #.#
# #.#.....#   #...#...#              ...# #.#...#   #...#     #.# #   #.#...#...#...#     # #   # #.#
# #.#.###.### #.#.#.#.#################.# #.# ### # ###.#######.# # # #.###.#.#.# #.# ####### ### #.#
# #.#.# #.# # #.#...#.....#.....#.......#...#     # # #.#.......#   # #...#...#.# #.#     #     # #.#
# #.#.# #.# # #.#########.#.###.#.#######.######### # #.#.########### ###.#####.# #.# ### # ##### #.#
# #...# #.#   #...#   # #...# #.#.#     #.....#       #.#.              #...#...# #.#   #   # #   #.#
# ##### #.#######.# # # ##### #.#.# #########.#########.#.#################.#.### #.### ##### # # #.#
#     #...#.....#.# #   #   # #...# #     # #.........#.#.#.................#.#   #...#       # # #.#
# #####.###.###.#.# ### # # # ##### # # # # #########.#.#.#.#################.##### #.######### ###.#
#     #...#.# #...# # #   # #     #   # #     #.......#.#.#...........#     #.....# #.#.......#   #.#
# ### ###.#.# ##### # ##### ### # ##### ##### #.#######.#.###########.# #########.# #.#.#####.### #.#
# # #   #...#   #   #         # # #     # #   #.# #    ...          #.#         #.# #...    #...# #.#
# # # ####### # # # ######### # # # ##### # ###.# # ############# ###.# ### # ###.# ###########.# #.#
#   #         # # #         #   #   #   #   #...#   #...#.....#   #...# #   # #...#     #.....#.#...#
### ######### # ########### ######### # # ###.#######.#.#.###.#####.### # ### #.####### #.###.#.#.###
# # #       # #             # #       # # # #.....#...#...# #...#...#   #   # #.......# #...#...#...#
# # # ##### # ############### # ####### # # #####.#.####### ###.#.######### # #######.# ###.#######.#
#   # #     #       #     #     #     #   #     #...#         #...#   #     #   #   #.#   #.#   #...#
# ### # ########### ##### # ######### ##### ### ##### ####### ##### # # ####### # # #.#####.# ###.###
# #   #     #       #     # # #     #       #     #       #       # #   #     #   # #.......#.....# #
# ### ### ### ####### ##### # # # # ######### ### ##### # ####### # ##### ######### #########.##### #
#   #   # #   #   #   #     #   # # #     #   # #     # #       #   #     #       # # #.......#     #
### ### # # ### # # # # ##### ### # # ### # ### ##### # ####### ####### # # ##### # # #.####### ### #
# # #   # #     # # # # #     # # #   # #   #     #   #   #   # #       # #   # #     #.......#   # #
# # # ### ####### # ### # ##### # ##### ##### ### # ##### ### # # ### ####### # #############.# # ###
# # # # #   #   # #     #       #   #   #   #   # #   # #     # # # # #     # #     #.........# #   #
# # # # ### ### # ### ##### ##### # # # # # ### # ### # ##### # # # # # # ### ##### #.############# #
# #   #   # #   #   #     # #   # # # #   #     #   # #     # # # #   # #           #...#    .....# #
# ##### # # # # ### ##### ### # ### ### ######### # # ##### # # # ##### ###############.### #.###.# #
#   #   # #   # #   #   #     #   #   #   #       # # #     # # #       #.......#.....#...# #.#  .# #
# # # ### ##### # ### # ######### # # ##### ##### ### # ##### # #########.#####.#.###.###.# #.###.# #
# #     #     # # #   # #   #     # # #   #     # #   #       #   #.......#   #...# #...#.# #...#...#
######### # ### # ### # # # # ##### # # # ##### ### ### ######### #.######### ##### ###.#.# ###.###.#
#       # # #   #   # # # # #     # # # # #   #   #   #         # #.#.....#.....#...  #.#.# #...#...#
# ##### # ### ##### # # # # ##### ### # # # # ### ### ########### #.#.###.#.###.#.#.###.#.###.###.###
#     # #     #   # # # # # #         # #   #     #   #           #...# #.#...#...#.#...#.#...# #...#
##### # ####### # # # # # ### ######### ######### # ### ######### ##### #.###.#####.#.###.#.### ###.#
#     #       # # # # #   #   #.....# #   #   #   # # #     #   #       #...#...# #.#.....#.#     #.#
# # ######### # # # # ##### ###.###.# # # # # # ### # # ### # ####### #####.###.# #.#######.# #####.#
# # #   #   #   #   #         #...#.#   # # # #   # #   #   #     #   #.....#...# #...#.....#.......#
# ### # ### ######### ###########.#.### # # # ##### # ### ##### ### ###.#####.### ###.#.#####.#######
#     #   #           # #.........#...# #   #       # #   #   #   #   #.# #  ...#...#...#...#.......#
# ####### ####### ##### #.###########.########### ### # ### # ### ### #.# # ###.#.#.#####.#.#######.#
#       #       #     # #.#.....#.....#.........#   # # #   #   #   # #.#     #.#.#.    #.#.....  #.#
##### ##### ### ##### # #.#.###.#.#####.#######.### ### # ##### # ### #.#######.#.#.#####.#####.###.#
#   # #   #   #   #     #...#...#...#...# #.....#     #     #   #     #.........#.#.......#   #.....#
# # ### # ##### # ##### #####.#####.#.### #.######### ####### ### ###############.########### #######
# #     #     # #     # #   #...# #.#...# #.....#...#       # # # #     #   #.....#    .....#       #
# ########### ####### # # #####.# #.###.# #####.#.#.####### # # # # # # ### #.#########.###.####### #
#   #                 # #     #...#.....#     #...#.......#   # # # # #     #...........#...#.......#
# # ################### # # # ###.########### ###########.##### # ### ##### #############.###.#####.#
# #   #         #     # # # # #...#         #         #...#...#   #   #       #   #...  #.#  .#.....#
# ### # ####### # ##### ### ###.### ##### # ######### #.###.#.### # ### ##### # ###.#.###.# #.#.#####
#   # # #     # #     #   #   #.# # # #   #         # #.....#...# # # # #...#   #...#...#.# #.#.#   #
### # # ##### # ### # ### ### #.# # # # ### ####### # #########.# # # # #.#.# ###.#####.#.###.#.# # #
#   #   #     #   # #   # #   #.# # # #   # #   # #   #       #.#   #   #.#.# #...#   #...#...#.# # #
# ####### ### ### ##### # # ###.# # # ### ### # # ### ####### #.##### ###.#.# #.##### #####.###.### #
#         #   #   #     # # #...#   #   #     # #         #   #.#     #...#.# #.#.........#...#...# #
##### ####### # ### ### # # #.### ##### ####### ######### # # #.#######.###.# #.#.#######.###.###.# #
# #   #     # #   #   # #   #...#       #     # #   #   #   # #.......#.# #.# #...#     #.#...# #.# #
# # ### ### # ### ### ##### ###.####### # ### # # # # # #############.#.# #.####### ### #.#.### #.# #
#     #   # #   #   # #     #...#...#     #   #   #   # #         # #.#.# #.....#.....# #.#...# #...#
# ####### # ####### # # #####.###.#.####### ####### ### # ##### # # #.#.# #####.#.###.###.###.# ###.#
# #     # #         # #     #.#  .#...#       #...# #   #   #   #   #...#     #.#.#...#...#...#   #.#
# # ### # ########### ##### #.# #.###.# #######.#.# # ##### # # ######### ### #.#.#.###.###.### # #.#
# # # # # #     #   #       #.# #...#.# #.......#.# # #   # # # #  ...#   #   #...#.....#  .#   #...#
### # # # # ### # # # #######.# ###.#.# #.#######.# # # # # # ### #.#.### # ###############.#####.###
#   #     # #   # # #   #.....# #...#.# #...#   #.# #   # # #     #.#...# #   #        ...#.....#...#
# ######### ##### # # ###.##### #.###.#####.# # #.##### # # #######.###.# ### # #######.#.#####.###.#
# #       #       #   #...#     #...#.#.....# # #.....# #     #...#.# #.#   #   #...#...#.......# #.#
# # ##### #############.##### #####.#.#.##### #######.#########.#.#.# #.####### #.#.#.########### #.#
# #   # #       #.......#...# #.....#.#...# #       #.....#...#.#.#.# #...#...# #.#...#     #     #.#
# ### # ####### #.#######.#.###.#####.###.# # # #########.#.#.#.#.#.# ###.#.#.###.##### # ### ### #.#
#             #  .........#.....#    .....#   #          ...#...#...#    ...#.....#     #       #  .#
#####################################################################################################
