#####################################################################################################
#   #     #           #           #             #           #     #               #   #             #
### # # ### ##### ### ### ####### # ##### ##### ####### ### # # ### # ########### # # # ####### ### #
#   # #     #   #   #   #   #   #       #   #     #     # # # #     #   #   #     # # # #     #   # #
# ### ####### # ### ### # ### # ######### # ##### # ##### # ### ####### # # # ##### # # ### ##### ###
# #   #   #   #     # # # #   #         # #     #   #   # #   #   #   # # #   #     # #   #     #   #
# # ### ### ######### # ### ########### # ##### ##### # # ### ##### # # # ######### # ### # # ##### #
# # #   #   #       # #     #   #     # #     #     # # #   #     # #   #   #     # #   # # #     # #
# # ### # ##### ### # ####### # ### # # ####### ### # # # ####### # ####### # ### # ### # ##### # # #
# #     # #     # #   #       #   # # #       #   #   # #       # # #     # #   #   #   #     # # # #
# ####### # ##### ### # ######### ### ####### ##### ### # # ##### # # ##### ### ##### ####### # # # #
#         #   #     #   #     #   #     #   #     # # # # #     #   #     #   # #   # #       # # # #
########### # # ### ####### # # ### ### ### ##### # # # # ##### ######### ### # # ### ### ##### # # #
# #         # #   #   #     # # #   #       #     #   # # #   #             #   #       #   #   # # #
# # ######### # # ##### # ##### # ### ##### # ######### # # # # ############### ####### ### # ##### #
# # #     #   # #       # #     # #   #   # # #         #   # #                 #   # #   #   #     #
# # # ### # ######### ### # ##### ##### # # # # # ################# ############# # # ### ##### ### #
#   # #   # #       # #   # #     #     # # # # #           #     # #   #         # #   #     #   # #
# ### # # # # ##### # # ### ### # # ##### ### ##### ####### # ### ### # # ####### # # # ##### ### # #
# #   # # # #     # # #   # #   # #     # #   #   # #       #   #     #   #     # # # #     # #   # #
# ##### # # ##### # ### # # # ### # ##### # ### # ### ##### ### ########### ### # # ####### # # #####
#     # # # #     #   # #   # #   # #     # #   #     # #   #   #   #     #   # # #   #   # # #     #
##### # # # # ####### # ##### ##### # ##### ### # ##### # ### ##### # ### ### # # ### # # # # ##### #
# #   # # #   #     # #       #   # #       #   # #   #   # #       # #       # # #   # #   #       #
# # ### ####### ##### ######### # # ######### ##### # # ### ####### # ######### ### ### ### ####### #
# # #               #           #   #       # #     # #   #   #     #   #       #   #     #   #   # #
# # ####### ####### ################# ##### # # ##### ### ### # ####### # ####### ####### # ### # # #
# # #     #   #   #   #                 # # #   #   #   #     # # #   # #   #   #   #     # #   # # #
# # # ### ### # # # # ################# # # # ### # ### ####### # # # # ### # # # # # ####### ### # #
# # # # # # # # #   #     #     #       #   #     # # # #       #   # #   #   # # # #     #     # # #
# # # # # # # # ######### # ### # ####### ######### # # # ########### ### ##### # # # ### # ##### # #
# #   # # #   #   #   # #   # # # #     #     #       # #               #   #   # # #   #   # #   # #
# ##### # ####### # # # ##### # # # ######### ######### # ################# # ### # ### ##### # # # #
#     #   #     # # #   #   # #   # #     # #         # # #                 # #   #   #       # # # #
# ##### ### ### # # ### # # # ##### # # # # ######### # # # ################# ##### # ######### ### #
#     #   # # #   # # #   # #     #   # #     #       # # #           #     #     # # #       #   # #
# ### ### # # ##### # ##### ### # ##### ##### # ####### # ########### # ######### # # # ##### ### # #
# # #   #   #   #   #         # # #     # #   # # #                 # #         # # #       #   # # #
# # # ####### # # # ######### # # # ##### # ### # # ############# ### # ### # ### # ########### # # #
#   #         # # #         #   #   #   #   #   #   #   #     #   #   # #   # #   #     #     # #   #
### ######### # ########### ######### # # ### ####### # # ### ##### ### # ### # ####### # ### # # ###
# # #       # #             # #       # # # #     #   #   # #   #   #   #   # #       # #   #   #   #
# # # ##### # ############### # ####### # # ##### # ####### ### # ######### # ####### # ### ####### #
#   # #     #       #     #     #     #   #     #   #         #   #   #     #   #   # #   # #   #   #
# ### # ########### ##### # ######### ##### ### ##### ####### ##### # # ####### # # # ##### # ### ###
# #   #     #       #     # # #     #       #     #       #       # #   #     #   # #       #     # #
# ### ### ### ####### ##### # # # # ######### ### ##### # ####### # ##### ######### ######### ##### #
#   #   # #   #   #   #     #   # # #     #   # #     # #       #   #     #       # # #       #     #
### ### # # ### # # # # ##### ### # # ### # ### ##### # ####### ####### # # ##### # # # ####### ### #
# # #   # #     # # # # #     # # #   # #   #     #   #   #   # #       # #   # #     #       #   # #
# # # ### ####### # ### # ##### # ##### ##### ### # ##### ### # # ### ####### # ############# # # ###
# # # # #   #   # #     #       #   #   #   #   # #   # #     # # # # #     # #     #         # #   #
# # # # ### ### # ### ##### ##### # # # # # ### # ### # ##### # # # # # # ### ##### # ############# #
# #   #   # #   #   #     # #   # # # #   #     #   # #     # # # #   # #           #   #         # #
# ##### # # # # ### ##### ### # ### ### ######### # # ##### # # # ##### ############### ### # ### # #
#   #   # #   # #   #   #     #   #   #   #       # # #     # # #       #       #     #   # # #   # #
# # # ### ##### # ### # ######### # # ##### ##### ### # ##### # ######### ##### # ### ### # # ### # #
# #     #     # # #   # #   #     # # #   #     # #   #       #   #       #   #   # #   # # #   #   #
######### # ### # ### # # # # ##### # # # ##### ### ### ######### # ######### ##### ### # # ### ### #
#       # # #   #   # # # # #     # # # # #   #   #   #         # # #     #     #     # # # #   #   #
# ##### # ### ##### # # # # ##### ### # # # # ### ### ########### # # ### # ### # # ### # ### ### ###
#     # #     #   # # # # # #         # #   #     #   #           #   # # #   #   # #   # #   # #   #
##### # ####### # # # # # ### ######### ######### # ### ######### ##### # ### ##### # ### # ### ### #
#     #       # # # # #   #   #     # #   #   #   # # #     #   #       #   #   # # #     # #     # #
# # ######### # # # # ##### ### ### # # # # # # ### # # ### # ####### ##### ### # # ####### # ##### #
# # #   #   #   #   #         #   # #   # # # #   # #   #   #     #   #     #   # #   #     #       #
# ### # ### ######### ########### # ### # # # ##### # ### ##### ### ### ##### ### ### # ##### #######
#     #   #           # #         #   # #   #       # #   #   #   #   # # #     #   #   #   #       #
# ####### ####### ##### # ########### ########### ### # ### # ### ### # # # ### # # ##### # ####### #
#       #       #     # # #     #     #         #   # # #   #   #   # # #     # # #     # #       # #
##### ##### ### ##### # # # ### # ##### ####### ### ### # ##### # ### # ####### # # ##### ##### ### #
#   # #   #   #   #     #   #   #   #   # #     #     #     #   #     #         # #       #   #     #
# # ### # ##### # ##### ##### ##### # ### # ######### ####### ### ############### ########### #######
# #     #     # #     # #   #   # # #   # #     #   #       # # # #     #   #     #         #       #
# ########### ####### # # ##### # # ### # ##### # # ####### # # # # # # ### # ######### ### ####### #
#   #                 # #     #   #     #     #   #       #   # # # # #     #           #   #       #
# # ################### # # # ### ########### ########### ##### # ### ##### ############# ### ##### #
# #   #         #     # # # # #   #         #         #   #   #   #   #       #   #     # #   #     #
# ### # ####### # ##### ### ### ### ##### # ######### # ### # ### # ### ##### # ### # ### # # # #####
#   # # #     # #     #   #   # # # # #   #         # #     #   # # # # #   #   #   #   # # # # #   #
### # # ##### # ### # ### ### # # # # # ### ####### # ######### # # # # # # # ### ##### # ### # # # #
#   #   #     #   # #   # #   # # # # #   # #   # #   #       # #   #   # # # #   #   #   #   # # # #
# ####### ### ### ##### # # ### # # # ### ### # # ### ####### # ##### ### # # # ##### ##### ### ### #
#         #   #   #     # # #   #   #   #     # #         #   # #     #   # # # #         #   #   # #
##### ####### # ### ### # # # ### ##### ####### ######### # # # ####### ### # # # ####### ### ### # #
# #   #     # #   #   # #   #   #       #     # #   #   #   # #       # # # # #   #     # #   # # # #
# # ### ### # ### ### ##### ### ####### # ### # # # # # ############# # # # ####### ### # # ### # # #
#     #   # #   #   # #     #   #   #     #   #   #   # #         # # # # #     #     # # #   # #   #
# ####### # ####### # # ##### ### # ####### ####### ### # ##### # # # # # ##### # ### ### ### # ### #
# #     # #         # #     # #   #   #       #   # #   #   #   #   #   #     # # #   #   #   #   # #
# # ### # ########### ##### # # # ### # ####### # # # ##### # # ######### ### # # # ### ### ### # # #
# # # # # #     #   #       # # #   # # #       # # # #   # # # #     #   #   #   #     #   #   #   #
### # # # # ### # # # ####### # ### # # # ####### # # # # # # ### # # ### # ############### ##### ###
#   #     # #   # # #   #     # #   # # #   #   # # #   # # #     # #   # #   #           #     #   #
# ######### ##### # # ### ##### # ### ##### # # # ##### # # ####### ### # ### # ####### # ##### ### #
# #       #       #   #   #     #   # #     # # #     # #     #   # # # #   #   #   #   #       # # #
# # ##### ############# ##### ##### # # ##### ####### ######### # # # # ####### # # # ########### # #
# #   # #       #       #   # #     # #   # #       #     #   # # # # #   #   # # #   #     #     # #
# ### # ####### # ####### # ### ##### ### # # # ######### # # # # # # ### # # ### ##### # ### ### # #
#             #           #     #         #   #             #   #   #       #     #     #       #   #
#####################################################################################################
